1 1 1 1 1
1 c 1 0 1
1 0 0 0 1
1 0 m 1 1
1 1 1 1 1